beginnen: beginne, beginnst, beginnt, beginnen, beginnt, beginnen; begonnen
bezahlen: bezahle, bezahlst, bezahlt, bezahlen, bezahlt, bezahlen; bezahlt
sein: bin, bist, ist, sind, seid, sind; gewesen
brauchen: brauche, brauchst, braucht, brauchen, braucht, brauchen; gebraucht
bringen: bringe, bringst, bringt, bringen, bringt, bringen; gebracht
denken: denke, denkst, denkt, denken, denkt, denken; gedacht
essen: esse, isst, isst, essen, esset, essen; gegessen
fahren: fahre, fährst, fährt, fahren, fahrt, fahren; gefahren
gehen: gehe, gehst, geht, gehn, geht, gehn; gegangen
haben: habe, hast, hat, haben, habt, haben; gehabt
heißen: heiße, heißt, heißt, heißen, heißt, heißen; geheißen
hören: höre, hörst, hört, hören, hört, hören; gehört
kennen: kenne, kennst, kennt, kennen, kennt, kennen; gekannt
kommen: komme, kommst, kommt, kommen, kommt, kommen; gekommen
laufen: laufe, läufst, läuft, laufen, lauft, laufen; gelaufen
lernen: lerne, lernst, lernt, lernen, lernt, lernen; gelernt
lesen: lese, liest, liest, lesen, leset, lesen; gelesen
machen: mache, machst, macht, machen, macht, machen; gemacht
mögen: mag, magst, mag, mögen, mögt, mögen; gemocht
reichen: reiche, reichst, reicht, reichen, reicht, reichen; gereicht
rennen: renne, rennst, rennt, rennen, rennt, rennen; gerannt
schlafen: schlafe, schläfst, schläft, schlafen, schlaft, schlafen; geschlafen
schmecken: schmecke, schmeckst, schmeckt, schmecken, schmeckt, schmecken; geschmeckt
schreiben: schreibe, schreibst, schreibt, schreiben, schreibt, schreiben; geschrieben
schwimmen: schwimme, schwimmst, schwimmt, schwimmen, schwimmt, schwimmen; geschwommen
sehen: sehe, siehst, sieht, sehen, seht, sehen; gesehen
spielen: spiele, spielst, spielt, spielen, spielt, spielen; gespielt
sprechen: spreche, sprichst, spricht, sprechen, sprecht, sprechen; gesprochen
trinken: trinke, trinkst, trinkt, trinken, trinkt, trinken; getrunken
verstehen: verstehe, verstehst, versteht, verstehn, versteht, verstehn; verstanden
waschen: wasche, wäschst, wäscht, waschen, wascht, waschen; gewaschen
wollen: will, willst, will, wollen, wollt, wollen; gewollt