ich	Pronoun	5 hours ago	
nicht	Adverb	5 hours ago	
du	Pronoun	5 hours ago	
wir	Pronoun	5 hours ago	
trinken	Verb	5 hours ago	
das	Pronoun	5 hours ago	
er	Pronoun	5 hours ago	
und	Conjunction	5 hours ago	
es	Pronoun	5 hours ago	
den	Determiner	5 hours ago	
brauche	Verb	5 hours ago	
waschen	Verb	5 hours ago	
bezahlen	Verb	5 hours ago	
wäscht	Verb	5 hours ago	
reicht	Verb	5 hours ago	
beginnen	Verb	5 hours ago	
bezahlst	Verb	5 hours ago	
ein	Determiner	5 hours ago	
langsam	Adjective	5 hours ago	
Buch	Noun	5 hours ago	
der	Determiner	5 hours ago	
schwimmen	Verb	5 hours ago	
rennt	Verb	5 hours ago	
fahren	Verb	5 hours ago	
schwimmt	Verb	5 hours ago	
kennen	Verb	5 hours ago	
bringen	Verb	5 hours ago	
denken	Verb	5 hours ago	
rennen	Verb	5 hours ago	
lesen	Verb	23 hours ago	
die	Determiner	23 hours ago	
das	Determiner	23 hours ago	
ihr	Pronoun	23 hours ago	
liest	Verb	23 hours ago	
sie	Pronoun	23 hours ago	
lese	Verb	23 hours ago	
Zeitung	Noun	23 hours ago	
mag	Verb	23 hours ago	
magst	Verb	23 hours ago	
lest	Verb	23 hours ago	
schreibt	Verb	23 hours ago	
lernst	Verb	23 hours ago	
hörst	Verb	23 hours ago	
sehe	Verb	23 hours ago	
siehst	Verb	23 hours ago	
esse	Verb	23 hours ago	
Frau	Noun	23 hours ago	
Kind	Noun	23 hours ago	
schläft	Verb	23 hours ago	
schläfst	Verb	23 hours ago	
spielst	Verb	23 hours ago	
mache	Verb	23 hours ago	
wollen	Verb	23 hours ago	
laufe	Verb	23 hours ago	
geht	Verb	23 hours ago	
spielen	Verb	23 hours ago	
warm	Adjective	2 days ago	
tief	Adjective	2 days ago	
sauber	Adjective	2 days ago	
schmutzig	Adjective	2 days ago	
hoch	Adjective	2 days ago	
ist	Verb	2 days ago	
klar	Adjective	2 days ago	
kalt	Adjective	2 days ago	
alt	Adjective	2 days ago	
jung	Adjective	2 days ago	
schwer	Adjective	2 days ago	
bist	Verb	2 days ago	
richtig	Adjective	2 days ago	
müde	Adjective	2 days ago	
neu	Adjective	2 days ago	
bin	Verb	2 days ago	
schnell	Adjective	2 days ago	
teuer	Adjective	2 days ago	
weit	Adjective	2 days ago	
bitte	Adverb	2 days ago	
wichtig	Adjective	2 days ago	
schön	Adjective	2 days ago	
schlecht	Adjective	3 days ago	
lustig	Adjective	3 days ago	
traurig	Adjective	3 days ago	
fertig	Adjective	3 days ago	
gesund	Adjective	3 days ago	
leicht	Adjective	3 days ago	
einfach	Adjective	3 days ago	
rund	Adjective	3 days ago	
nein	Adverb	3 days ago	
sind	Verb	3 days ago	
groß	Adjective	3 days ago	
ruhig	Adjective	3 days ago	
klein	Adjective	3 days ago	
Männer	Noun	3 days ago	
Kinder	Noun	3 days ago	
lang	Adjective	3 days ago	
stark	Adjective	3 days ago	
leise	Adjective	3 days ago	
kurz	Adjective	3 days ago	
laut	Adjective	3 days ago	
schwach	Adjective	3 days ago	
Junge	Noun	4 days ago	
normal	Adjective	4 days ago	
toll	Adjective	4 days ago	
frei	Adjective	4 days ago	
perfekt	Adjective	4 days ago	
Mädchen	Noun	4 days ago	
isst	Verb	4 days ago	
Brot	Noun	4 days ago	
essen	Verb	4 days ago	
Milch	Noun	4 days ago	
Vögel	Noun	4 days ago	
Enten	Noun	4 days ago	
Äpfel	Noun	4 days ago	
hat	Verb	4 days ago	
eine	Determiner	4 days ago	
habe	Verb	4 days ago	
Mann	Noun	4 days ago	
Katzen	Noun	4 days ago	
Orangen	Noun	4 days ago	
Tomaten	Noun	4 days ago	
Spinnen	Noun	4 days ago	
Bananen	Noun	4 days ago	
Fliegen	Noun	4 days ago	
Bären	Noun	5 days ago	
Insekten	Noun	5 days ago	
Menschen	Noun	5 days ago	
Zeitungen	Noun	5 days ago	
Eier	Noun	5 days ago	
Kartoffeln	Noun	5 days ago	
haben	Verb	5 days ago	
Mäuse	Noun	5 days ago	
Kühe	Noun	5 days ago	
Schweine	Noun	5 days ago	
Tiere	Noun	5 days ago	
Fische	Noun	5 days ago	
Insekt	Noun	5 days ago	
Käfer	Noun	5 days ago	
Fliege	Noun	5 days ago	
Biene	Noun	5 days ago	
Schwein	Noun	5 days ago	
Pferd	Noun	5 days ago	
Haustier	Noun	5 days ago	
Vogel	Noun	5 days ago	
Kuh	Noun	5 days ago	
Ente	Noun	5 days ago	
einen	Determiner	5 days ago	
Hund	Noun	5 days ago	
Katze	Noun	5 days ago	
Tier	Noun	5 days ago	
Bär	Noun	5 days ago	
Maus	Noun	5 days ago	
gut	Adjective	1 week ago	
Salz	Noun	1 week ago	
Nudeln	Noun	1 week ago	
Öl	Noun	1 week ago	
Reis	Noun	1 week ago	
süß	Adjective	1 week ago	
lecker	Adjective	1 week ago	
frisch	Adjective	1 week ago	
Schokolade	Noun	1 week ago	
Zucker	Noun	1 week ago	
Erdbeere	Noun	1 week ago	
schmeckt	Verb	1 week ago	
Kartoffel	Noun	1 week ago	
Käse	Noun	1 week ago	
Ei	Noun	1 week ago	
trinke	Verb	1 week ago	
Orange	Noun	1 week ago	
Apfelsaft	Noun	1 week ago	
Obst	Noun	1 week ago	
Saft	Noun	1 week ago	
Orangensaft	Noun	1 week ago	
Durst	Noun	1 week ago	
Bier	Noun	1 week ago	
Tee	Noun	1 week ago	
Kaffee	Noun	1 week ago	
Wein	Noun	1 week ago	
Eis	Noun	1 week ago	
habt	Verb	1 week ago	
Hunger	Noun	1 week ago	
Fisch	Noun	1 week ago	
Pizza	Noun	1 week ago	
Essen	Noun	1 week ago	
Suppe	Noun	1 week ago	
ja	Adverb	1 week ago	
Deutsch	Noun	1 week ago	
Englisch	Noun	1 week ago	
verstehe	Verb	1 week ago	
versteht	Verb	1 week ago	
verstehen	Verb	1 week ago	
spricht	Verb	1 week ago	
sprechen	Verb	1 week ago	
spreche	Verb	1 week ago	
aus	Preposition	1 week ago	
komme	Verb	1 week ago	
kommen	Verb	1 week ago	
kommt	Verb	1 week ago	
kommst	Verb	1 week ago	
deutschland	Proper noun	1 week ago	
hallo	Interjection	1 week ago	
hans	Proper noun	1 week ago	
julia	Proper noun	1 week ago	
heiße	Verb	1 week ago	
karl	Proper noun	1 week ago	
heißt	Verb	1 week ago	
hast	Verb	1 week ago	
esst	Verb	2 weeks ago	
trinkst	Verb	2 weeks ago	
Apfel	Noun	2 weeks ago	
Frauen	Noun	2 weeks ago	
Bücher	Noun	2 weeks ago	
trinkt	Verb	2 weeks ago	
danke	Interjection	2 weeks ago	
keine ahnung		2 weeks ago	
wie geht's		2 weeks ago	
mir geht's gut		2 weeks ago	
alles klar		2 weeks ago	
es tut mir leid		2 weeks ago	
in ordnung		2 weeks ago	
genau		2 weeks ago	
leider	Adverb	2 weeks ago	
Entschuldigung	Noun	2 weeks ago	
bis bald		2 weeks ago	
auf wiedersehen		2 weeks ago	
gute nacht		2 weeks ago	
bis morgen		2 weeks ago	
bis später		2 weeks ago	
guten morgen		3 weeks ago	
guten tag		3 weeks ago	
willkommen	Adjective	3 weeks ago	
gern geschehen		3 weeks ago	
guten abend		3 weeks ago	
tschüss	Interjection	3 weeks ago	
Jungen	Noun	3 weeks ago	
seid	Verb	3 weeks ago	
